9 126 0 1
8 126 0 0
10 126 0 1
9 125 1 1
11 126 0 1
13 126 0 1
8 125 0 1
12 126 0 1
14 126 0 1
